
NO maps/textures/testingB/North.xpm
SO maps/textures/testingB/South.xpm
WE maps/textures/testingB/West.xpm
EA maps/textures/testingB/East.xpm

F 237,158,84
C 167,243,255

     11111111111111111111
    1100000000000000000011
   110000000000000000000011
  11000000000000000000000011
 1100000000000000000000000011
110000000000000000000000000011
1100000000000000000000000000011
1100000000000000000000000000011
1100000000000000000000000000011
1100000000000000000000000000011
110000000000N000000000000000011
1100000000000000000000000000011
1100000000000000000000000000011
1100000000000000000000000000011
1100000000000000000000000000011
 11000000000000000000000000011
  110000000000000000000000011
   1100000000000000000000011
    11000000000000000000011
     110000000000000000011
      1111111111111111111