NO final_maps/textures/north2.xpm
SO final_maps/textures/south2.xpm
WE final_maps/textures/west2.xpm
EA final_maps/textures/east2.xpm

F 88,57,39
C 19,58,58  

11111111111111111111111111111111111111111111111111
10000000000000000000000000000000000000000000000001
10111100000000111111111100000000000111111111111111
100000000000000000000000000000000000000000000010011111111111111111111111111
1111100100000000000000000000000000000000000000000000000000000000000000S0001
100000000000000000000000000000000000000000000000000000000000000001000000001
101111111111111111111111111111111111111111000000011111111111111111110000001
10000000000000000000000000000000000000000000000001                 10000001
110000000000000000000000000000000000000000000001111111111111111111110000001
111111111111111111111111111111111110000000000000000000000000000000000000001
100000000000000000000000000000000000000000000000000000000000000000000000001
100001111111111111111111111111111111110000000000000000000111111111111111111
10000100000000000000000000000000000000000000001001111111111
111111111111111111111111111111111111111111111111111
