NO final_maps/textures/north1.xpm
SO final_maps/textures/south1.xpm
WE final_maps/textures/west1.xpm
EA final_maps/textures/east1.xpm
F 88,57,39
C 19,58,58          
1111111111111111111
1000100000000000001
1000100000000000001
1000111110000000001
1000000010001000001
1000000010000100001
100000000W000000001
1000100001000000001
1000100000000000001
1000100000000000001
1000100000111100001
1000000000000000001
1000000000000000001
1111111111111111111